*******#*#**#*********#*******#*******#****##*###******###*##***##**#********************#***#*#**#*
#******##******#****#***#***********###*#**#***##**********#*****#*#*#****###**#***********#****#***
*#***####***#******##*##**#**####*****#*#*##*****#******#*********#*#*#**S#**#****##*##*#**#*##*#***
*********#****###**#*****##*##*****#*##***#****#***#****#*#*##***#******#***#****#***###***#*******#
#***#**##**#**#***#****##*******##*****G#*#*****##*******##***************#****#*#*****#********#**#
**#*#*********#****#*#**#***#*#*##*****#*##*****##***#***##*###**#**##*##*****#********#*#***##**#*#
##*#*#**###*####*###***#*##**#*#****#**********##***#**##*#*#*****#*#**#*##********##*****#*****##**
**##*#****##**##**#**#***#******#****#**###***#******#*##**#********###**#**#********#******#**####*
**###*#***#**********#**##************##********#*#*****#**##****************###*#*##**********#****
**********#****#*****#***###***#*****#*#*#*#**#**##****#*#***#*******#****#********#********#*#*****
#***######***#***********#**#****#******#***#**###*****#**#*##*******#*#*****#********#*********#*#*
*##*****##***#*##*******#******************#****#*#***##***#*#**#*********#****##**#****#****#*###**
**#**#*#**#*###*******#******#*****##*##***#***#*#******##**#********#*#****************#**##****###
******#*****#*##*#*****#*##***#*##*##******#*#*#*#******###***#**#********#*********###*#**#*****#**
##*#*******#*#*#**##**#***##*##**#*#*********##*##*#*#***#***##*#***##*##***#*************#**##*****
*****##****##***#*********###****#******#*#*#*******#*#*****#*##**##**#***##****#*#******#**#*##****
*###*##*#**###*********#*#**#**********##****#******####***#*##*#****#**#*##***#******#**#*********#
*#*#*#*#*#***##*#************************#***#*#*#***##***#*#******##*##*#******#******#********###*
#*#*#**#*#****#**#**#****#*#*******#*#****#****#*#*#****##******#*#**#*#*****#****#***************##
#*#******#*************#**#*#****##*##********#********##*##************#*#*****#**#********####**#*
**#********************#**##*******#*##***#*#*#*##*#*****###***#***********##*#********##*#*******##
*#*#***##******##***#*#****#****#******#******#**##***#*##*#********##*#*#*#**###****#**#**#**##****
##*******#*#**#*******#*#***##***#*#**#****#*#*******#*##**#*###*#******#******##**##**###*##*#*****
#*******#*##**##*#*#**#*#****#*#**#**************#******##*##**********#**#*#*#*##*#**#****#**###*##
***#*****#*#**##*#***#*##*********#****##**#*******##*#***#*******#**#*****#***#******##**#***#**#**
*#**#*#**##**#***#*##*****#*#*********#******#**#**********##*******#*#*****#***#*****#**********###
*##***##***#**#*##********#****##****#*#*********#*##*#*######*******#***#**##******#**#********#**#
****#*******####*#**#**###****#***###***##***#*#***#**#***#*********#**#***#***#*******#****#**##***
******#***###******##*##****##*****##**##******#***#*##*#*#****#********#*#*#**#***##***#*#####*****
*********######*#*******##****#*****#**#*###**#***#***#*#*##*##******#****#*#**#*#*##*#***###*******
#****#**#*********#***#*####*******#**#*******#*###**#****###*#*#****##**#****#**##***##*****#*##*#*
******##*##***###*******##**#**###*****#*#***#*#***#****#****##**##**#***##*##*#**##*****##*#******#
#***#****#*#*#*****##**######*#*#******##**#***#*****#*****#**#***##**#*#******#*#****#****#********
****##*#***###**#***#*#********#***#***#***#*##***#****###*#**#*************#*#**#********##****#***
#********#*#******#*#***#**###***#******#*##**#**#***##*##***#**********#**********##**#**#*****##*#
*#**********#*###****##*********#****##****#*##*#*#*****#****#*******##*****#*****#*#*#**#*#********
##*#*#******##**###*#****#**#*****##**###**#*#*****#***********#*#****#**##******##***#***#****#****
***#********#**#***#***************#**#*******#*##****#****************#####**#********#*****#*##***
*******#***#**#*#********##****#*#**##*****#****#*#*##*#******##****#*#***##***#*******#*#*#*##*#**#
*****##***#****#*#**##***#**####*###**##**##****#*****#*#**#*##***#**********##*#*****###**#*#*#****
#**#*********###********#**#********##*#*#*********#*#*********#****##*###*************#******#*#*#*
##**#**#*****************#***#*#****#*********#***##*###*******##*#*********##****#**#*****#*#*****#
#****##***##**##***#**##*#*#******#****#****#***##**#*****#**#***##****##**##****##****###**#***###*
*#***#**#*##**#****#**##**#****#**#*#**#********#*#***#*#*##******#*******#*#####**************#****
##*********#**#**##***#***********#***#*******#**###*****#*********#***#***************#**#**##***#*
*#**#****#*******#***#*******#***#*#*****#**#****#*##******####*#*#*****#****#*#****#*****##*###**#*
**#************#*#*##**##**#*#******#*#***#*#*#****#****#**#***********##*#******#**#***#*#*##**##**
#*****##*#***#*##*#*##**#*#**#*#*##****#****#*##***##***##*******#*****#******#**###*#***********##*
#*##*****#*#**#******#***##******#****#**#******#*****#*#**#**#****************#******#***#******##*
##***#**#*********#***#*****#*#**#****#*###*****#**#****#***###*******#*********#*******#*####*####*
*****##**##***#*******#*#******#***#**##****#***#**##****#****##**##****##********#*#***#***##**#**#
*#******#*##******#******##*****#*#********##***##*****##**#**#*******#*###**##**#*******#****###**#
******#***#*#**#*#*****###**#**#**##******#**###**#****#****#***#****###*#**##**#******#*#####**#**#
***##****#**#*#*###***##***********#***#*#*#*#**#****#**#*#********#**#**##**#******#**#*###***#**#*
*###*#*#**#*#********#******#*######**#****###*###*****#*#*#**##********##*###***#********###**#*#**
#*****#**##***##*****#**#********#******************##*#**#*#*##****#*##*****#**#*#****#************
***#**#*****#**#*#****#**###*#*#************#*##*****#*##***#**#******#***#****#####******#*#**##**#
#***##**************#******#**#***##*##******##**#*#****#***#####*****************##*###*#****#****#
*#**#####******#******##*****#*#**#*******#****#****###****###*#*******#**#********#***#***********#
*#******#******#******#***#**#**#************##**##****##*#*##*####**#***#*#**#*#***###***#**#*#****
#**#**#**##******#******#*#****#****#*##*#**#**********####*#*##***#*****##**#**#**#*******#**#*#**#
****##*****##*******###***##**#***##*******#*#*##*##***#****#*#******##*##***********#*****#*##*****
****##**#**#**#**#**#***#**###*##**#***#***#*#*#****#***#******#*#*#*##*##*#*******##**#*#*#********
***##*#**#****#*#********#****#*******#*****#****#***##*#*****#*******#**##***#*******##*#******#**#
#***#*###****#********#*******#***#*#*#*####*****#**#**#*#******#*#**#*###*#***#*##***#**#**#*******
*#*#*##*****#**##**#*****#************##****#***####****#*#********#***##**##*#*****#*##*#******##**
**##******#*#****#***##*#**##*#***##**#************##******##**********#*#***#*#**##**#**##****#**#*
******##*####**********#**#****##***###**#*#**#*#*#****####*#*####**#*************#***********#*****
****#*#***#***#*****#***##*****#*#*##**#******####******#***##*#*#************#********#**#*###**###
********#************##**#***#****##**##*##***##**#*##***#***#***#****#**********************#**#*##
**##*#*#***#*##*#*#****##*#**#*##**##**#***********#*##***##*##**##******##***#*#**##**##*#*#**#**#*
*#*#**********#*#****##***##**#*#******#**#**#*******#****#****##*##*********#*#*##*#*******#*******
*#***#*****##*********#*********##*****#*************#*##****#*##**#***#*#**###*#**##****##*********
******##**********#****#*#****#*##*****#**##****#***#**##*#*************##*******#***************#*#
*##**#*##*#**#*#***##***#***##***********#***#********###****#**#*****#**##*##******#*#**#*#**#****#
#********************##********#*##****#*##**#***#*##*#****#******#*#**#*#***##**********#*#**#*#*#*
*****#***#***#***##***#**###*#*#****#**#*#*********#****####***#**#*##***#*#****#*##*****###*#******
**#**#***#****#**###**##********##******##**#*##**#*##**#*#*#*****##**#####******#**#*****##*****#**
#*#**##*******#******#*##********##**#*##***#*#***#***##****##*#*******#***#*****#*******###********
**#**********##*******##******#*******##*###**#*##****#*#****#*****#****#**#*##*#*#**#***###**#*#**#
**###*##*#*****#*#******#*##***#*#******#*#*###*#***#***#****##********###*#*#*****#*#**###********#
***#*#*#*#********##*#*#**##*#*****#*****##**#*******##************#***#*#**#*##*##***#*****#*#*****
*###**#*******#****#***#**#*#*#*#****#******#*#*****#****##*************#***#*#****##*#******##***##
*#****#*****#*****#***##**#*#******###**#*#*#************###*#***#*****#**#*******#*****#******#*#*#
**##*#####*##***#*******##***#*************#**##********#*##**#****#*##*****#*****#*****#*#**###*#**
****##**#**#*****#***#*******#*******#*#*#*#*##**#***#***#**#**##***#****#***#*##*##**#*#****#**###*
#****#****#***#*#*##***##*****###****#*#*#*##*#******##**##*****##*#**#********##**#**#*##**#*#*###*
##**#******#*#********###**********#*###*****#*#*##***#*##***#*#*##***###****##*#*#****#***#**#***#*
***#**************##*********##*#*#*#*******##**#*****#*##**#*********##*#*#*##****#****#****##*##**
*#******#***#*******##*********#*##**##*##**###*#*****#*******#**#*#******##**##**##*#**##*#***#****
***#*#************#*****##*#***##***#**##*#*#*#*#**##****#***#******#***#*#***#*##***#*#**##*******#
#*#*#****#**#*#**#**#***#**####*#**##**********###***#***#*#***####*********************#***********
**#******#*#*#*#**###*****#*******#**#**#******#**#*#***#****#*###*##**********##*********#*#**#*##*
#*#*******#***************#***#***##*#*****#*#*###**#***#*******#*#***#*#*****##**#***#*##*****#**#*
**#***#*##****##**#*##*********#*****#******#*#*#****#**#*##***##*#****#*#**#****##*##**###****#**#*
#*******#**##*#*#**********#*##**********#********#**###***##***#***#***********##*****#**#*#*#*####
***********##*#***#**###*#*#**#****##**********#****#****#**#*******###***#*#****#*#*#***##****#***#
****###***#******#***#**####***#****#***********#*#****#*#**#*#***##*###*###***###**##**#**#*#***#*#
#*****#****#***#*#******##**##*#****####**#****#************#***#****#*##***#***#*****#*###***#**#**
##***********#********##***#**#*##****#*#*****#****#**#***#*#**#*#*#***#*#*****#*****************#**