####***####
#*S**#***##
########*##
##*******##
######*##*#
#*G*##****#
###########